NO ./textures/bricks.xpm
SO ./textures/glass.xpm

EA ./textures/bookshelf.xpm


C 225,30,0
F 120,220,36
WE ./textures/rocks.xpm

11111111
10100001
10100001
10000001
100N0001
11111111