NO ./textures/bricks.xpm
SO ./textures/glass.xpm
WE ./textures/rocks.xpm
EA ./textures/bookshelf.xpm

F 220,100,0
C 225,30,0

 11 1111
100101
101001
1100N1
11111